   *****
****   *
*  *#  ****
* ##      *
*P  *# #* *
*** *   * *
 *  ***** *
 *  ooooo *
 **********