     ******
     *    *
     *#   *
   ***   #**
   *  #  # *
 *** * **  *  *******
 *   * **  ****   oo*
 * #  #           oo* 
 ***** *** *P**   oo*
     *     **********
     ********