  *****
 **   *****
**        ***
*    *      *
* o  *   # **
*    *    *
******  P**
     *****