*****
*   *
* * ****
*    *P*
* * #  ***
*o*      *
*oo # *  *
* ***** **
*  #    *
******  *
     ****