 ******
 *    **
**o**# *
* oo#  *
*  *#  *
* P  ***
******